1 0 0 64 64 0
-1 64 -1 -1 -1 -1 -1 -1 -1 -1 -1 -1 -1 -1 -1 -1 
80 88 -1 -1 -1 -1 2 -1 -1 -1 -1 -1 -1 -1 -1 -1 
121 91 -1 -1 -1 -1 2 -1 -1 -1 -1 -1 -1 -1 -1 -1 
121 91 0 -1 -1 -1 -1 -1 -1 2 -1 -1 -1 -1 -1 -1 
82 82 90 2 -1 -1 -1 -1 -1 2 -1 -1 -1 -1 -1 -1 
120 120 91 82 82 82 82 82 82 82 90 -1 -1 -1 -1 -1 
121 121 91 84 84 84 84 84 84 84 92 -1 -1 -1 -1 -1 
121 121 91 144 144 144 144 144 144 246 -1 -1 -1 -1 -1 -1 
121 121 91 144 144 144 144 144 144 246 -1 -1 -1 -1 -1 -1 
121 121 91 144 144 144 144 144 144 246 -1 -1 -1 -1 -1 -1 
121 121 91 144 144 144 144 144 144 246 -1 -1 -1 -1 -1 -1 
121 121 91 144 144 144 144 144 144 246 -1 -1 -1 -1 -1 -1 
121 121 91 144 144 144 144 144 144 246 -1 -1 -1 -1 -1 -1 
121 121 91 144 144 144 144 144 144 246 -1 -1 -1 -1 -1 -1 
121 121 91 144 144 144 82 82 82 246 -1 -1 -1 -1 -1 -1 
121 121 91 144 144 75 83 83 83 91 -1 -1 -1 -1 -1 -1 
121 121 91 144 144 75 83 83 83 91 -1 -1 -1 -1 -1 -1 
121 121 91 144 144 75 83 83 83 91 -1 -1 -1 -1 -1 -1 
121 121 91 144 144 144 84 84 84 -1 -1 -1 -1 -1 -1 -1 
121 121 91 144 144 144 246 -1 -1 -1 -1 -1 -1 -1 -1 -1 
121 121 91 144 144 144 246 -1 -1 -1 -1 -1 -1 -1 -1 -1 
121 121 91 144 144 144 246 -1 -1 -1 -1 -1 -1 -1 -1 -1 
121 121 91 144 144 144 246 -1 -1 -1 2 -1 -1 -1 -1 -1 
121 121 91 144 144 144 246 -1 -1 -1 2 -1 -1 -1 -1 -1 
121 121 91 82 82 82 246 -1 -1 -1 2 -1 -1 -1 -1 -1 
121 121 91 0 0 0 245 -1 -1 -1 2 -1 -1 -1 -1 -1 
64 64 143 0 0 0 0 -1 -1 -1 2 -1 -1 -1 -1 -1 
0 0 0 0 0 0 0 -1 -1 -1 2 -1 -1 -1 -1 -1 
0 0 0 0 0 0 0 -1 -1 -1 -1 -1 -1 -1 -1 -1 
0 0 0 0 0 0 0 -1 -1 -1 -1 -1 -1 -1 -1 -1 
0 0 0 0 0 0 0 -1 -1 -1 -1 -1 -1 -1 -1 -1 
0 0 0 0 0 0 0 -1 -1 -1 -1 -1 -1 -1 -1 -1 -2
1 1 1 1 1 1 1 1 1 1 1 1 1 1 1 1 
1 1 0 0 0 0 1 0 0 0 0 0 0 0 0 0 
0 1 0 0 0 0 1 0 0 0 0 0 0 0 0 0 
0 1 0 0 0 0 0 0 0 1 0 0 0 0 0 0 
0 1 1 1 0 0 0 0 0 1 0 0 0 0 0 0 
0 0 0 1 1 1 1 1 1 1 1 0 0 0 0 0 
0 0 1 1 1 1 1 1 1 1 1 0 0 0 0 0 
0 0 1 0 0 0 1 0 0 0 0 0 0 0 0 0 
0 0 1 0 0 0 1 0 0 0 0 0 0 0 0 0 
0 0 1 0 0 1 0 0 0 0 0 0 0 0 0 0 
0 0 1 0 0 0 0 0 0 0 0 0 0 0 0 0 
0 0 1 0 0 0 0 0 0 0 0 0 0 0 0 0 
0 0 1 0 0 0 0 0 0 0 0 0 0 0 0 0 
0 0 1 0 0 0 0 0 0 0 0 0 0 0 0 0 
0 0 1 0 0 1 1 1 1 1 0 0 0 0 0 0 
0 0 1 0 0 1 0 0 0 1 0 0 0 0 0 0 
0 0 1 0 0 1 0 0 0 1 0 0 0 0 0 0 
0 0 1 0 0 1 0 0 0 1 0 0 0 0 0 0 
0 0 1 0 0 1 1 1 1 1 0 0 0 0 0 0 
0 0 1 0 0 0 0 0 0 0 0 0 0 0 0 0 
0 0 1 0 0 0 0 0 0 0 0 0 0 0 0 0 
0 0 1 0 0 0 0 0 0 0 0 0 0 0 0 0 
0 0 1 0 0 0 0 0 0 0 1 0 0 0 0 0 
0 0 1 0 0 0 0 0 0 0 1 0 0 0 0 0 
0 0 1 1 1 1 1 0 0 0 1 0 0 0 0 0 
0 0 1 1 1 1 1 0 0 0 1 0 0 0 0 0 
1 1 1 0 0 0 0 0 0 0 1 0 0 0 0 0 
0 0 0 0 0 0 0 0 0 0 1 0 0 0 0 0 
0 0 0 0 0 0 0 0 0 0 0 0 0 0 0 0 
0 0 0 0 0 0 0 0 0 0 0 0 0 0 0 0 
0 0 0 0 0 0 0 0 0 0 0 0 0 0 0 0 
0 0 0 0 0 0 0 0 0 0 0 0 0 0 0 0 
