0 0 0 64 64 0
-1 -1 -1 -1 -1 -1 -1 -1 -1 -1 -1 -1 -1 -1 -1 -1 
-1 -1 -1 -1 -1 -1 -1 -1 -1 -1 -1 -1 -1 -1 -1 -1 
-1 -1 -1 -1 -1 -1 -1 -1 -1 -1 -1 -1 -1 -1 -1 -1 
-1 -1 -1 -1 -1 -1 -1 -1 -1 -1 -1 -1 -1 -1 -1 -1 
-1 -1 -1 -1 -1 -1 -1 -1 -1 -1 -1 -1 -1 -1 -1 -1 
-1 -1 -1 -1 -1 -1 -1 -1 -1 -1 -1 -1 -1 -1 -1 -1 
-1 -1 -1 -1 -1 -1 -1 -1 -1 -1 -1 -1 -1 -1 -1 -1 
-1 -1 -1 -1 106 -1 3 -1 -1 -1 -1 -1 -1 -1 -1 -1 
-1 -1 -1 106 -1 -1 3 -1 -1 -1 -1 -1 -1 -1 -1 -1 
-1 -1 -1 -1 -1 3 -1 -1 -1 -1 -1 -1 -1 -1 -1 -1 
-1 -1 -1 -1 -1 -1 -1 -1 -1 -1 -1 -1 -1 -1 -1 -1 
-1 -1 -1 -1 -1 -1 -1 -1 -1 -1 -1 -1 -1 -1 -1 -1 
-1 -1 -1 -1 -1 -1 -1 -1 -1 -1 -1 -1 -1 -1 -1 -1 
-1 -1 -1 -1 -1 -1 -1 -1 -1 -1 -1 -1 -1 -1 -1 -1 
-1 -1 -1 -1 -1 74 98 98 98 90 -1 -1 -1 -1 -1 -1 
-1 -1 -1 -1 -1 77 -1 -1 -1 77 -1 -1 -1 -1 -1 -1 
-1 -1 -1 -1 -1 -1 -1 -1 -1 77 -1 -1 -1 -1 -1 -1 
-1 -1 -1 -1 -1 -1 77 -1 -1 77 -1 -1 -1 -1 -1 -1 
-1 -1 -1 -1 -1 76 77 -1 -1 92 -1 -1 -1 -1 -1 -1 
-1 -1 -1 -1 -1 -1 -1 -1 -1 -1 -1 -1 -1 -1 -1 -1 
-1 -1 -1 -1 -1 -1 -1 -1 -1 -1 -1 -1 -1 -1 -1 -1 
-1 -1 -1 -1 -1 -1 -1 -1 -1 -1 -1 -1 -1 -1 -1 -1 
-1 -1 -1 -1 -1 -1 -1 -1 -1 -1 -1 -1 -1 -1 -1 -1 
-1 -1 -1 -1 -1 -1 -1 -1 -1 -1 -1 -1 -1 -1 -1 -1 
-1 -1 -1 -1 -1 -1 90 -1 -1 -1 -1 -1 -1 -1 -1 -1 
-1 -1 -1 84 84 84 92 -1 -1 -1 -1 -1 -1 -1 -1 -1 
84 84 92 143 143 143 245 -1 -1 -1 -1 -1 -1 -1 -1 -1 
143 143 143 143 143 143 245 -1 -1 -1 -1 -1 -1 -1 -1 -1 
143 143 143 143 143 143 245 -1 -1 -1 -1 -1 -1 -1 -1 -1 
143 143 143 143 143 143 245 -1 -1 -1 -1 -1 -1 -1 -1 -1 
143 143 143 143 143 143 245 -1 -1 -1 -1 -1 -1 -1 -1 -1 
143 143 143 143 143 143 245 -1 -1 -1 -1 -1 -1 -1 -1 -1 -2
