1 0 0 64 64 0
0 0 0 0 0 0 0 0 0 0 0 0 0 0 0 0 0 0 0 0 0 0 0 0 0 0 0 0 0 0 0 0 
83 91 -1 -1 -1 -1 -1 -1 -1 -1 75 83 83 83 83 83 83 83 83 83 83 83 83 83 83 83 83 83 83 83 83 83 
83 91 -1 -1 -1 -1 -1 -1 -1 -1 75 83 83 83 83 83 83 83 83 83 83 83 83 83 83 83 83 83 83 83 83 83 
83 91 -1 -1 -1 -1 -1 -1 -1 -1 75 83 83 83 83 83 83 83 83 83 83 83 83 83 83 83 83 83 83 83 83 83 
83 91 0 0 -1 -1 -1 -1 -1 -1 75 83 83 83 83 83 83 83 83 83 83 83 83 83 83 83 83 83 83 83 83 83 
83 91 2 0 -1 -1 -1 -1 -1 -1 75 83 83 83 83 83 83 83 83 83 83 83 83 83 83 83 83 83 83 83 83 83 
83 91 0 0 -1 0 -1 -1 -1 -1 75 83 83 83 83 83 83 83 83 83 83 83 83 83 83 83 83 83 83 83 83 83 
83 91 0 0 -1 -1 -1 -1 -1 -1 75 83 83 83 83 83 83 83 83 83 83 83 83 83 83 83 83 83 83 83 83 83 
83 91 0 0 -1 240 -1 -1 -1 -1 75 83 83 83 83 83 83 83 83 83 83 83 83 83 83 83 83 83 83 83 83 83 
83 91 0 0 -1 -1 -1 -1 -1 -1 76 84 84 84 84 84 84 84 84 84 84 84 84 84 84 84 84 84 84 84 84 84 
83 91 0 3 3 3 -1 -1 -1 -1 236 241 -1 236 241 -1 236 241 -1 236 -1 -1 -1 -1 -1 -1 -1 -1 -1 -1 -1 -1 
83 91 0 0 -1 240 -1 0 -1 -1 236 241 -1 236 241 -1 236 -1 -1 -1 -1 -1 -1 -1 -1 -1 -1 -1 -1 -1 -1 -1 
83 91 0 0 -1 0 -1 0 -1 -1 236 241 -1 236 -1 -1 -1 -1 -1 -1 -1 -1 -1 -1 -1 -1 -1 -1 -1 -1 -1 -1 
83 0 0 0 0 -1 -1 0 -1 -1 236 -1 -1 -1 -1 -1 -1 -1 -1 -1 -1 -1 -1 -1 -1 -1 -1 -1 -1 -1 -1 -1 
83 0 0 0 0 -1 -1 0 -1 -1 -1 -1 -1 -1 -1 -1 -1 -1 -1 -1 -1 -1 -1 -1 -1 -1 -1 -1 -1 -1 -1 -1 
0 0 0 0 0 -1 -1 -1 -1 -1 -1 -1 -1 -1 -1 -1 -1 -1 -1 -1 -1 -1 -1 -1 -1 -1 -1 -1 -1 -1 -1 -1 
0 0 -1 -1 -1 -1 -1 -1 -1 -1 -1 -1 -1 -1 -1 -1 -1 -1 -1 -1 -1 -1 -1 74 82 82 82 82 82 82 82 82 
0 0 -1 -1 -1 -1 -1 -1 -1 -1 -1 -1 -1 -1 -1 -1 -1 -1 -1 -1 -1 -1 -1 75 83 83 83 83 83 83 83 83 
0 0 -1 -1 -1 -1 -1 -1 -1 -1 -1 -1 -1 -1 -1 -1 -1 -1 -1 -1 -1 -1 -1 75 83 83 83 83 83 83 83 83 
83 91 241 241 241 241 241 -1 -1 -1 -1 -1 -1 -1 -1 -1 -1 -1 -1 -1 -1 -1 -1 75 83 83 83 83 83 83 83 83 
83 91 80 80 80 88 241 241 241 241 241 -1 -1 -1 -1 -1 -1 -1 -1 -1 -1 -1 -1 75 83 83 83 83 83 83 83 83 
83 91 83 83 83 91 80 80 80 88 241 241 241 241 241 -1 -1 -1 -1 -1 -1 -1 -1 75 83 83 83 83 83 83 83 83 
83 91 83 83 83 91 83 83 83 91 80 80 80 88 241 241 241 241 -1 -1 -1 -1 -1 75 83 83 83 83 83 83 83 83 
83 91 83 83 83 91 83 83 83 91 83 83 83 91 80 80 80 88 -1 -1 240 -1 -1 75 83 83 83 83 83 83 83 83 
83 91 83 83 83 91 83 83 83 91 83 83 83 91 81 81 81 89 -1 -1 240 -1 -1 75 83 83 83 83 83 83 83 83 
83 91 83 83 83 91 83 83 83 91 81 81 81 89 241 241 241 241 -1 -1 -1 -1 -1 75 83 83 83 83 83 83 83 83 
83 91 83 83 83 91 81 81 81 89 241 241 241 241 241 -1 -1 -1 -1 -1 -1 -1 -1 75 83 83 83 83 83 83 83 83 
83 91 81 81 81 89 241 241 241 241 241 -1 -1 -1 -1 -1 -1 -1 -1 -1 -1 -1 -1 75 83 83 83 83 83 83 83 83 
0 0 241 241 241 241 241 241 241 241 241 -1 -1 -1 -1 -1 -1 -1 -1 -1 -1 -1 -1 75 83 83 83 83 83 83 83 83 
-1 -1 241 241 -1 -1 241 0 0 -1 -1 -1 0 3 3 3 0 0 0 -1 -1 -1 -1 75 83 83 83 83 83 83 83 83 
0 0 241 -1 -1 -1 241 0 0 -1 -1 -1 0 3 3 3 0 0 0 -1 -1 -1 -1 75 83 83 83 83 83 83 83 83 
83 91 241 3 -1 -1 241 0 0 -1 -1 -1 0 3 3 3 0 0 0 -1 -1 -1 -1 75 83 83 83 83 83 83 83 83 
83 91 241 3 -1 -1 241 0 -1 -1 -1 -1 0 3 3 3 0 0 0 -1 -1 -1 -1 75 83 83 83 83 83 83 83 83 
83 91 241 3 -1 -1 241 0 -1 -1 -1 -1 -1 -1 -1 -1 -1 -1 -1 -1 -1 -1 -1 75 83 83 83 83 83 83 83 83 
83 91 241 3 -1 -1 241 0 -1 -1 -1 -1 0 3 3 3 0 0 0 -1 -1 -1 -1 76 84 84 84 84 84 84 84 84 
83 91 241 241 -1 -1 241 0 -1 -1 -1 -1 0 3 3 3 0 0 0 -1 -1 -1 -1 -1 -1 -1 -1 -1 -1 -1 -1 -1 
83 91 87 241 -1 -1 241 0 161 -1 -1 -1 0 3 3 3 0 0 0 -1 -1 -1 -1 -1 -1 -1 -1 -1 -1 -1 -1 -1 
83 91 95 241 -1 -1 -1 161 236 -1 161 161 0 3 3 3 0 0 0 -1 -1 -1 -1 -1 -1 -1 -1 -1 -1 -1 -1 -1 
83 91 83 87 241 -1 161 161 161 161 161 236 161 161 161 161 161 161 161 161 161 161 -1 -1 -1 -1 -1 -1 -1 -1 -1 -1 
83 91 83 95 241 -1 -1 161 236 -1 -1 -1 -1 161 236 -1 -1 161 161 -1 -1 161 -1 -1 -1 -1 -1 -1 -1 -1 -1 -1 
83 91 83 83 87 241 161 161 161 161 161 236 161 161 161 161 161 236 161 161 161 161 -1 -1 -1 -1 -1 -1 -1 -1 -1 -1 
83 91 83 83 95 241 -1 161 236 -1 -1 -1 -1 161 236 -1 -1 -1 161 161 236 -1 -1 -1 -1 -1 -1 -1 -1 -1 -1 -1 
83 91 83 83 91 -1 -1 161 161 161 161 236 161 161 161 161 161 236 161 161 -1 -1 -1 -1 -1 -1 -1 -1 -1 -1 -1 -1 
83 91 83 83 91 -1 -1 161 236 -1 -1 -1 -1 -1 236 -1 -1 -1 -1 -1 -1 -1 -1 -1 -1 -1 -1 -1 -1 -1 -1 -1 
83 91 83 83 91 -1 -1 -1 161 -1 -1 236 -1 -1 -1 -1 -1 -1 -1 -1 -1 -1 -1 -1 -1 -1 -1 -1 -1 -1 -1 -1 
83 91 83 83 91 -1 -1 -1 236 -1 -1 -1 -1 -1 -1 -1 -1 -1 -1 -1 -1 -1 -1 -1 -1 -1 -1 -1 -1 -1 -1 -1 
83 91 83 83 91 -1 -1 -1 -1 -1 -1 -1 -1 -1 -1 -1 -1 -1 -1 -1 -1 -1 -1 -1 -1 -1 -1 -1 -1 -1 -1 -1 
0 0 0 0 0 0 0 0 0 0 0 0 0 0 0 0 0 0 0 0 0 0 0 0 0 0 0 0 0 0 0 0 -2
1 1 1 1 1 1 1 1 1 1 1 1 1 1 1 1 1 1 1 1 1 1 1 1 1 1 1 1 1 1 1 1 
0 1 0 0 0 0 0 0 0 0 1 0 0 0 0 0 0 0 0 0 0 0 0 0 0 0 0 0 0 0 0 0 
0 1 0 0 0 0 0 0 0 0 1 0 0 0 0 0 0 0 0 0 0 0 0 0 0 0 0 0 0 0 0 0 
0 1 0 0 0 0 0 0 0 0 1 0 0 0 0 0 0 0 0 0 0 0 0 0 0 0 0 0 0 0 0 0 
0 1 0 0 0 0 0 0 0 0 1 0 0 0 0 0 0 0 0 0 0 0 0 0 0 0 0 0 0 0 0 0 
0 1 1 0 0 0 0 0 0 0 1 0 0 0 0 0 0 0 0 0 0 0 0 0 0 0 0 0 0 0 0 0 
0 1 0 0 0 0 0 0 0 0 1 0 0 0 0 0 0 0 0 0 0 0 0 0 0 0 0 0 0 0 0 0 
0 1 0 0 0 0 0 0 0 0 1 0 0 0 0 0 0 0 0 0 0 0 0 0 0 0 0 0 0 0 0 0 
0 1 0 0 0 1 0 0 0 0 1 0 0 0 0 0 0 0 0 0 0 0 0 0 0 0 0 0 0 0 0 0 
0 1 0 0 0 0 0 0 0 0 1 1 1 1 1 1 1 1 1 1 1 1 1 1 1 1 1 1 1 1 1 1 
0 1 0 1 1 1 0 0 0 0 1 0 0 1 0 0 1 0 0 1 0 0 0 0 0 0 0 0 0 0 0 0 
0 1 0 0 0 1 0 0 0 0 1 0 0 1 0 0 1 0 0 0 0 0 0 0 0 0 0 0 0 0 0 0 
0 1 0 0 0 0 0 0 0 0 1 0 0 1 0 0 0 0 0 0 0 0 0 0 0 0 0 0 0 0 0 0 
0 1 1 1 1 0 0 0 0 0 1 0 0 0 0 0 0 0 0 0 0 0 0 0 0 0 0 0 0 0 0 0 
0 1 1 1 1 0 0 0 0 0 0 0 0 0 0 0 0 0 0 0 0 0 0 0 0 0 0 0 0 0 0 0 
1 1 0 0 0 0 0 0 0 0 0 0 0 0 0 0 0 0 0 0 0 0 0 0 0 0 0 0 0 0 0 0 
0 0 0 0 0 0 0 0 0 0 0 0 0 0 0 0 0 0 0 0 0 0 0 1 1 1 1 1 1 1 1 1 
0 0 0 0 0 0 0 0 0 0 0 0 0 0 0 0 0 0 0 0 0 0 0 1 0 0 0 0 0 0 0 0 
1 1 0 0 0 0 0 0 0 0 0 0 0 0 0 0 0 0 0 0 0 0 0 1 0 0 0 0 0 0 0 0 
0 1 0 0 0 0 0 0 0 0 0 0 0 0 0 0 0 0 0 0 0 0 0 1 0 0 0 0 0 0 0 0 
0 1 0 0 0 2 0 0 0 0 0 0 0 0 0 0 0 0 0 0 0 0 0 1 0 0 0 0 0 0 0 0 
0 1 0 0 0 2 0 0 0 2 0 0 0 0 0 0 0 0 0 0 0 0 0 1 0 0 0 0 0 0 0 0 
0 1 0 0 0 2 0 0 0 2 0 0 0 2 0 0 0 0 0 0 0 0 0 1 0 0 0 0 0 0 0 0 
0 1 0 0 0 2 0 0 0 2 0 0 0 2 0 0 0 2 0 0 1 0 0 1 0 0 0 0 0 0 0 0 
0 1 0 0 0 2 0 0 0 2 0 0 0 2 0 0 0 2 0 0 1 0 0 1 0 0 0 0 0 0 0 0 
0 1 0 0 0 2 0 0 0 2 0 0 0 2 0 0 0 0 0 0 0 0 0 1 0 0 0 0 0 0 0 0 
0 1 0 0 0 2 0 0 0 2 0 0 0 0 0 0 0 0 0 0 0 0 0 1 0 0 0 0 0 0 0 0 
0 1 0 0 0 2 0 0 0 0 0 0 0 0 0 0 0 0 0 0 0 0 0 1 0 0 0 0 0 0 0 0 
1 1 0 0 0 0 0 0 0 0 0 0 0 0 0 0 0 0 0 0 0 0 0 1 0 0 0 0 0 0 0 0 
0 0 0 0 0 0 0 0 0 0 0 0 0 1 1 1 1 1 1 0 0 0 0 1 0 0 0 0 0 0 0 0 
1 1 0 0 0 0 0 0 0 0 0 0 0 1 1 1 0 0 0 0 0 0 0 1 0 0 0 0 0 0 0 0 
0 1 0 1 0 0 0 0 0 0 0 0 0 1 1 1 0 0 0 0 0 0 0 1 0 0 0 0 0 0 0 0 
0 1 0 1 0 0 0 0 0 0 0 0 0 1 1 1 1 1 1 0 0 0 0 1 0 0 0 0 0 0 0 0 
0 1 0 1 0 0 0 0 0 0 0 0 0 0 0 0 0 0 0 0 0 0 0 1 0 0 0 0 0 0 0 0 
0 1 0 1 0 0 0 0 0 0 0 0 0 1 1 1 1 1 1 0 0 0 0 1 1 1 1 1 1 1 1 1 
0 9 0 0 0 0 0 0 0 0 0 0 0 1 1 1 0 0 0 0 0 0 0 0 0 0 0 0 0 0 0 0 
0 1 3 0 0 0 0 0 0 0 0 0 0 1 1 1 0 0 0 0 0 0 0 0 0 0 0 0 0 0 0 0 
0 1 4 0 0 0 0 0 1 0 0 0 0 1 1 1 1 1 1 0 0 0 0 0 0 0 0 0 0 0 0 0 
0 1 0 3 0 0 0 0 0 0 0 1 0 0 0 0 0 0 0 0 0 0 0 0 0 0 0 0 0 0 0 0 
0 1 0 4 0 0 0 0 1 0 0 0 0 0 1 0 0 0 0 0 0 0 0 0 0 0 0 0 0 0 0 0 
0 1 0 0 3 0 0 0 0 0 0 1 0 0 0 0 0 1 0 0 0 0 0 0 0 0 0 0 0 0 0 0 
0 1 0 0 4 0 0 0 1 0 0 0 0 0 1 0 0 0 0 0 1 0 0 0 0 0 0 0 0 0 0 0 
0 1 0 0 9 0 0 0 0 0 0 1 0 0 0 0 0 1 0 0 0 0 0 0 0 0 0 0 0 0 0 0 
0 1 0 0 2 0 0 0 1 0 0 0 0 0 1 0 0 0 0 0 0 0 0 0 0 0 0 0 0 0 0 0 
0 1 0 0 2 0 0 0 0 0 0 1 0 0 0 0 0 0 0 0 0 0 0 0 0 0 0 0 0 0 0 0 
0 1 0 0 2 0 0 0 1 0 0 0 0 0 0 0 0 0 0 0 0 0 0 0 0 0 0 0 0 0 0 0 
0 1 0 0 2 0 0 0 0 0 0 0 0 0 0 0 0 0 0 0 0 0 0 0 0 0 0 0 0 0 0 0 
1 1 1 1 1 1 1 1 1 1 1 1 1 1 1 1 1 1 1 1 1 1 1 1 1 1 1 1 1 1 1 1 
