1 0 0 64 64 0
0 0 0 0 0 0 0 0 0 0 0 0 0 0 0 0 0 0 0 0 0 0 0 0 0 0 0 0 0 0 0 0 
19 27 -1 -1 -1 -1 -1 -1 -1 -1 -1 -1 -1 -1 -1 -1 -1 -1 -1 -1 -1 -1 3 -1 -1 -1 -1 -1 -1 -1 -1 0 
19 27 32 -1 -1 -1 -1 -1 -1 -1 -1 -1 -1 -1 -1 -1 -1 -1 -1 -1 -1 -1 3 -1 -1 -1 -1 -1 -1 -1 -1 0 
19 27 33 -1 -1 -1 -1 -1 -1 -1 -1 -1 -1 -1 -1 -1 -1 -1 -1 -1 -1 -1 3 241 241 241 241 241 241 241 241 0 
19 27 34 -1 -1 -1 -1 -1 -1 -1 10 18 18 26 -1 -1 -1 -1 -1 -1 -1 -1 3 241 241 241 241 241 241 241 241 0 
19 27 35 -1 -1 -1 -1 -1 -1 -1 11 19 19 27 -1 -1 -1 -1 -1 -1 -1 -1 3 241 241 241 241 241 241 241 241 0 
19 27 36 -1 -1 -1 -1 -1 -1 -1 11 19 19 27 -1 -1 -1 -1 -1 -1 -1 -1 3 241 241 241 241 241 241 241 241 0 
19 27 37 -1 -1 240 -1 -1 -1 -1 11 19 19 27 51 -1 -1 -1 -1 -1 -1 -1 3 241 241 241 241 241 241 241 241 0 
19 27 38 -1 -1 240 -1 -1 -1 -1 11 19 19 27 19 51 -1 -1 -1 -1 -1 -1 3 241 241 241 241 241 241 241 241 0 
19 27 -1 -1 -1 240 -1 -1 -1 -1 11 19 19 27 19 19 51 -1 -1 -1 -1 -1 3 -1 -1 -1 -1 -1 -1 -1 -1 0 
19 27 -1 -1 -1 -1 -1 -1 -1 -1 11 19 19 27 19 19 19 51 -1 -1 -1 -1 -1 -1 -1 -1 -1 -1 -1 -1 -1 0 
19 27 -1 -1 -1 -1 -1 -1 -1 -1 11 19 19 27 19 19 19 19 60 -1 -1 -1 -1 -1 -1 -1 -1 -1 -1 -1 -1 0 
19 27 -1 -1 -1 -1 -1 -1 -1 -1 11 19 19 27 19 19 19 53 61 -1 -1 -1 -1 -1 -1 -1 -1 -1 -1 -1 -1 0 
19 27 0 0 -1 -1 -1 -1 -1 -1 11 19 19 27 52 19 53 61 -1 -1 -1 -1 -1 -1 -1 -1 -1 -1 -1 -1 -1 0 
20 28 0 0 -1 -1 -1 -1 -1 -1 12 20 20 28 -1 46 61 -1 -1 -1 -1 -1 3 3 3 3 3 3 3 3 3 0 
-1 -1 -1 -1 -1 -1 -1 -1 -1 -1 3 3 -1 -1 -1 -1 -1 -1 -1 -1 -1 -1 3 -1 -1 -1 -1 -1 -1 -1 -1 0 
-1 -1 -1 -1 -1 -1 -1 -1 -1 3 3 -1 -1 -1 -1 -1 -1 -1 -1 -1 -1 -1 3 -1 241 241 241 241 241 241 -1 0 
0 0 0 0 -1 -1 -1 -1 3 3 -1 -1 -1 -1 -1 -1 -1 -1 -1 -1 -1 -1 3 -1 241 -1 0 -1 -1 241 -1 0 
18 26 0 0 -1 -1 -1 -1 3 -1 -1 -1 -1 -1 -1 -1 -1 3 3 -1 -1 -1 3 -1 241 -1 3 3 -1 241 -1 0 
19 27 0 0 -1 -1 -1 -1 -1 -1 -1 -1 -1 -1 -1 -1 -1 3 3 0 241 -1 3 -1 241 -1 3 3 -1 241 -1 0 
19 27 0 0 2 -1 -1 -1 -1 -1 -1 -1 -1 -1 -1 -1 -1 3 3 -1 241 -1 3 -1 241 -1 3 3 -1 241 -1 0 
19 27 21 21 21 21 29 -1 -1 -1 -1 -1 -1 -1 -1 -1 -1 3 3 -1 241 -1 3 -1 241 -1 3 3 -1 241 -1 0 
19 27 22 22 22 22 30 -1 -1 -1 -1 -1 -1 -1 -1 -1 -1 3 3 -1 241 -1 3 -1 241 -1 3 3 -1 241 -1 0 
19 27 -1 -1 -1 -1 -1 -1 -1 -1 -1 -1 -1 -1 -1 -1 -1 3 3 -1 241 -1 3 -1 241 -1 3 3 -1 241 -1 0 
20 28 -1 -1 -1 -1 -1 -1 -1 -1 -1 -1 -1 -1 -1 -1 -1 3 3 -1 241 -1 3 -1 241 -1 3 3 -1 241 -1 0 
-1 -1 -1 -1 -1 -1 -1 -1 10 26 -1 -1 -1 -1 -1 -1 -1 3 3 -1 241 -1 -1 -1 241 -1 3 3 -1 241 -1 0 
-1 2 -1 -1 -1 -1 -1 -1 11 27 -1 -1 -1 -1 -1 -1 -1 3 3 -1 241 241 241 241 241 -1 3 3 -1 241 -1 0 
-1 -1 -1 -1 -1 -1 -1 -1 11 39 23 -1 -1 -1 -1 -1 -1 3 3 -1 -1 -1 -1 -1 -1 -1 3 3 -1 241 -1 0 
-1 2 -1 -1 -1 -1 -1 -1 11 19 31 -1 -1 -1 -1 -1 -1 3 3 3 3 3 3 3 3 3 3 3 -1 241 -1 0 
-1 -1 -1 -1 -1 -1 -1 -1 11 19 39 23 -1 -1 -1 -1 -1 3 3 3 3 3 3 3 3 3 3 3 -1 241 -1 0 
18 26 -1 -1 -1 -1 -1 10 56 19 19 31 -1 -1 -1 -1 -1 -1 -1 -1 -1 -1 -1 -1 -1 -1 -1 -1 -1 241 -1 0 
19 27 -1 -1 -1 -1 -1 11 19 19 19 55 4 -1 -1 -1 -1 -1 -1 -1 -1 -1 -1 -1 -1 -1 -1 -1 -1 241 -1 0 
19 27 -1 -1 -1 -1 -1 11 19 19 43 19 55 4 -1 -1 -1 -1 -1 -1 -1 -1 -1 -1 -1 -1 -1 -1 -1 241 -1 0 
19 27 -1 -1 -1 -1 -1 11 19 19 44 19 19 6 -1 -1 -1 -1 -1 -1 -1 -1 -1 -1 -1 -1 -1 -1 -1 241 -1 0 
19 27 -1 -1 -1 -1 -1 11 19 19 45 19 62 54 -1 -1 -1 -1 -1 -1 -1 -1 -1 -1 -1 -1 -1 -1 241 241 -1 0 
19 27 -1 -1 -1 -1 -1 11 19 19 19 62 54 -1 -1 -1 -1 -1 -1 -1 -1 -1 -1 -1 -1 -1 -1 241 241 -1 -1 0 
19 27 -1 -1 -1 -1 -1 11 19 19 19 14 -1 -1 -1 -1 -1 -1 -1 -1 -1 -1 -1 -1 -1 -1 241 241 -1 -1 -1 0 
19 27 -1 -1 -1 -1 -1 11 19 19 47 15 -1 -1 -1 -1 236 -1 -1 -1 -1 -1 -1 -1 -1 241 241 -1 -1 -1 -1 0 
19 27 -1 -1 -1 -1 -1 11 19 19 14 -1 -1 -1 -1 -1 -1 236 -1 -1 -1 -1 -1 -1 241 241 -1 -1 -1 -1 -1 0 
19 27 -1 -1 -1 -1 -1 11 19 47 15 -1 -1 -1 -1 -1 -1 -1 236 -1 -1 -1 -1 241 241 -1 -1 -1 -1 -1 -1 0 
19 27 -1 -1 -1 -1 -1 11 19 14 -1 -1 -1 -1 -1 -1 -1 -1 -1 236 -1 -1 241 241 -1 -1 -1 -1 -1 -1 -1 0 
19 27 -1 -1 -1 -1 -1 11 47 15 -1 -1 -1 -1 -1 -1 -1 -1 236 -1 -1 241 241 -1 -1 -1 -1 -1 -1 -1 -1 0 
19 27 -1 -1 -1 -1 -1 11 27 -1 -1 -1 -1 -1 -1 -1 -1 236 -1 -1 -1 241 -1 -1 -1 -1 -1 -1 -1 -1 -1 0 
19 27 -1 -1 -1 -1 -1 11 27 -1 -1 -1 -1 -1 -1 -1 236 -1 -1 -1 -1 241 -1 -1 -1 -1 -1 -1 -1 -1 -1 0 
19 27 40 48 -1 -1 -1 12 28 -1 -1 -1 -1 -1 -1 -1 -1 236 -1 -1 -1 241 -1 -1 -1 -1 -1 -1 -1 -1 -1 0 
19 27 41 49 -1 -1 -1 -1 -1 -1 -1 -1 -1 -1 -1 -1 -1 -1 236 -1 -1 241 -1 -1 -1 -1 -1 -1 -1 -1 -1 0 
19 27 -1 -1 -1 -1 -1 -1 -1 -1 -1 -1 -1 -1 -1 -1 -1 -1 -1 236 -1 241 -1 -1 -1 -1 -1 -1 -1 -1 -1 0 
20 28 -1 -1 -1 -1 -1 -1 -1 -1 -1 -1 -1 -1 -1 -1 -1 -1 236 -1 -1 241 -1 -1 -1 -1 -1 -1 -1 -1 -1 0 
-1 -1 -1 -1 2 -1 -1 -1 -1 -1 -1 -1 -1 -1 -1 -1 -1 236 -1 -1 -1 241 -1 -1 -1 -1 -1 -1 -1 -1 -1 0 
18 26 -1 -1 -1 -1 -1 -1 -1 -1 -1 -1 -1 -1 -1 -1 236 -1 -1 -1 -1 241 -1 -1 -1 -1 -1 -1 -1 -1 -1 0 
19 27 -1 -1 -1 -1 -1 -1 -1 -1 -1 -1 -1 -1 -1 -1 -1 236 -1 -1 -1 241 -1 -1 -1 -1 -1 -1 -1 -1 -1 0 
19 27 -1 -1 -1 -1 -1 -1 -1 -1 -1 -1 -1 -1 -1 -1 -1 -1 236 -1 -1 241 -1 -1 -1 -1 -1 -1 -1 -1 -1 0 
19 27 -1 -1 -1 -1 -1 -1 -1 -1 -1 -1 -1 -1 -1 -1 -1 -1 -1 236 -1 241 -1 -1 -1 -1 -1 -1 -1 -1 -1 0 
19 27 -1 -1 -1 -1 -1 -1 -1 -1 -1 -1 -1 -1 -1 -1 -1 -1 -1 -1 236 241 -1 -1 -1 -1 -1 -1 -1 -1 -1 0 
19 27 -1 -1 -1 -1 -1 -1 -1 -1 -1 -1 -1 -1 -1 -1 -1 -1 -1 -1 236 241 -1 -1 -1 -1 -1 -1 -1 -1 -1 0 
19 27 -1 -1 -1 -1 -1 -1 -1 -1 -1 -1 -1 -1 -1 -1 -1 -1 -1 -1 236 241 -1 -1 -1 -1 -1 -1 -1 -1 -1 0 
19 27 -1 -1 -1 -1 -1 -1 -1 -1 -1 -1 -1 -1 -1 236 -1 -1 -1 -1 236 241 -1 -1 -1 -1 -1 -1 -1 -1 -1 0 
19 27 -1 -1 -1 -1 -1 -1 -1 -1 -1 -1 -1 -1 236 -1 -1 -1 -1 -1 236 241 -1 -1 -1 -1 -1 -1 -1 -1 -1 0 
19 27 -1 -1 -1 -1 -1 -1 -1 -1 -1 -1 -1 236 236 236 236 236 236 236 236 241 -1 -1 -1 -1 -1 -1 -1 -1 -1 0 
19 27 -1 -1 -1 -1 -1 -1 -1 -1 -1 -1 -1 -1 236 -1 -1 -1 -1 -1 -1 -1 -1 -1 -1 -1 -1 -1 -1 -1 -1 0 
19 27 -1 -1 -1 -1 -1 -1 -1 -1 -1 -1 -1 -1 -1 236 -1 -1 -1 -1 -1 -1 -1 -1 -1 -1 -1 -1 -1 -1 -1 0 
19 27 -1 -1 -1 -1 -1 -1 -1 -1 -1 -1 -1 -1 -1 -1 -1 -1 -1 -1 -1 -1 -1 -1 -1 -1 -1 -1 -1 -1 -1 0 
19 27 -1 -1 -1 -1 -1 -1 -1 -1 -1 -1 -1 -1 -1 -1 -1 -1 -1 -1 -1 -1 -1 -1 -1 -1 -1 -1 -1 -1 -1 0 
0 0 0 0 0 0 0 0 0 0 0 0 0 0 0 0 0 0 0 0 0 0 0 0 0 0 0 0 0 0 0 0 -2
1 1 1 1 1 1 1 1 1 1 1 1 1 1 1 1 1 1 1 1 1 1 1 1 1 1 1 1 1 1 1 1 
0 1 0 0 0 0 0 0 0 0 0 0 0 0 0 0 0 0 0 0 0 0 1 0 0 0 0 0 0 0 0 1 
0 1 0 0 0 0 0 0 0 0 0 0 0 0 0 0 0 0 0 0 0 0 1 0 0 0 0 0 0 0 0 1 
0 1 0 0 0 0 0 0 0 0 0 0 0 0 0 0 0 0 0 0 0 0 1 0 0 0 0 0 0 0 0 0 
0 1 0 0 0 0 0 0 0 0 1 1 1 1 0 0 0 0 0 0 0 0 1 0 0 0 0 0 0 0 0 0 
0 1 0 0 0 0 0 0 0 0 1 0 0 1 0 0 0 0 0 0 0 0 1 0 0 0 0 0 0 0 0 0 
0 1 0 0 0 0 0 0 0 0 1 0 0 1 0 0 0 0 0 0 0 0 1 0 0 0 0 0 0 0 0 0 
0 1 0 0 0 1 0 0 0 0 1 0 0 1 0 0 0 0 0 0 0 0 1 0 0 0 0 0 0 0 0 0 
0 1 0 0 0 1 0 0 0 0 1 0 0 1 0 0 0 0 0 0 0 0 1 0 0 0 0 0 0 0 0 0 
0 1 0 0 0 1 0 0 0 0 1 0 0 1 0 0 0 0 0 0 0 0 1 0 0 0 0 0 0 0 0 0 
0 1 0 0 0 0 0 0 0 0 1 0 0 1 0 0 0 0 0 0 0 0 0 0 0 0 0 0 0 0 0 0 
0 1 0 0 0 0 0 0 0 0 1 0 0 1 0 0 0 0 0 0 0 0 0 0 0 0 0 0 0 0 0 0 
0 1 0 0 0 0 0 0 0 0 1 0 0 1 0 0 0 0 8 0 0 0 0 0 0 0 0 0 0 0 0 0 
0 1 0 0 0 0 0 0 0 0 1 0 0 1 0 0 0 8 0 0 0 0 0 0 0 0 0 0 0 0 0 0 
1 1 0 0 0 0 0 0 0 0 1 1 1 1 0 0 8 0 0 0 0 0 1 1 1 1 1 1 1 1 1 0 
0 0 0 0 0 0 0 0 0 0 1 1 0 0 0 0 0 0 0 0 0 0 1 0 0 0 0 0 0 0 0 0 
0 0 0 0 0 0 0 0 0 1 1 0 0 0 0 0 0 0 0 0 0 0 1 0 0 0 0 0 0 0 0 0 
0 0 0 0 0 0 0 0 1 1 0 0 0 0 0 0 0 0 0 0 0 0 1 0 0 0 0 0 0 0 0 0 
1 1 0 0 0 0 0 0 1 0 0 0 0 0 0 0 0 1 1 0 0 0 1 0 0 0 1 1 0 0 0 0 
0 1 0 0 0 0 0 0 0 0 0 0 0 0 0 0 0 1 1 0 0 0 1 0 0 0 1 1 0 0 0 0 
0 1 0 0 1 0 0 0 0 0 0 0 0 0 0 0 0 1 1 0 0 0 1 0 0 0 1 1 0 0 0 0 
0 1 1 1 1 1 1 0 0 0 0 0 0 0 0 0 0 1 1 0 0 0 1 0 0 0 1 1 0 0 0 0 
0 1 1 1 1 1 1 0 0 0 0 0 0 0 0 0 0 1 1 0 0 0 1 0 0 0 1 1 0 0 0 0 
0 1 0 0 0 0 0 0 0 0 0 0 0 0 0 0 0 1 1 0 0 0 1 0 0 0 1 1 0 0 0 0 
1 1 0 0 0 0 0 0 0 0 0 0 0 0 0 0 0 1 1 0 0 0 1 0 0 0 1 1 0 0 0 0 
0 0 0 0 0 0 0 0 1 1 0 0 0 0 0 0 0 1 1 0 0 0 0 0 0 0 1 1 0 0 0 0 
0 1 0 0 0 0 0 0 1 9 0 0 0 0 0 0 0 1 1 0 0 0 0 0 0 0 1 1 0 0 0 0 
0 0 0 0 0 0 0 0 1 0 3 0 0 0 0 0 0 1 1 0 0 0 0 0 0 0 1 1 0 0 0 0 
0 1 0 0 0 0 0 0 1 0 4 0 0 0 0 0 0 1 1 1 1 1 1 1 1 1 1 1 0 0 0 0 
0 0 0 0 0 0 0 0 1 0 0 3 0 0 0 0 0 1 1 1 1 1 1 1 1 1 1 1 0 0 0 0 
1 1 0 0 0 0 0 1 1 0 0 4 0 0 0 0 0 0 0 0 0 0 0 0 0 0 0 0 0 0 0 0 
0 1 0 0 0 0 0 1 0 0 0 0 7 0 0 0 0 0 0 0 0 0 0 0 0 0 0 0 0 0 0 0 
0 1 0 0 0 0 0 1 0 0 0 0 0 7 0 0 0 0 0 0 0 0 0 0 0 0 0 0 0 0 0 0 
0 1 0 0 0 0 0 1 0 0 0 0 0 9 0 0 0 0 0 0 0 0 0 0 0 0 0 0 0 0 0 0 
0 1 0 0 0 0 0 1 0 0 0 0 0 8 0 0 0 0 0 0 0 0 0 0 0 0 0 0 0 0 0 0 
0 1 0 0 0 0 0 1 0 0 0 0 8 0 0 0 0 0 0 0 0 0 0 0 0 0 0 0 0 0 0 0 
0 1 0 0 0 0 0 1 0 0 0 6 0 0 0 0 0 0 0 0 0 0 0 0 0 0 0 0 0 0 0 0 
0 1 0 0 0 0 0 1 0 0 0 5 0 0 0 0 1 0 0 0 0 0 0 0 0 0 0 0 0 0 0 0 
0 1 0 0 0 0 0 1 0 0 6 0 0 0 0 0 0 1 0 0 0 0 0 0 0 0 0 0 0 0 0 0 
0 1 0 0 0 0 0 1 0 0 5 0 0 0 0 0 0 0 1 0 0 0 0 0 0 0 0 0 0 0 0 0 
0 1 0 0 0 0 0 1 0 6 0 0 0 0 0 0 0 0 0 1 0 0 0 0 0 0 0 0 0 0 0 0 
0 1 0 0 0 0 0 1 0 5 0 0 0 0 0 0 0 0 1 0 0 0 0 0 0 0 0 0 0 0 0 0 
0 1 0 0 0 0 0 1 9 0 0 0 0 0 0 0 0 1 0 0 0 0 0 0 0 0 0 0 0 0 0 0 
0 1 0 0 0 0 0 1 1 0 0 0 0 0 0 0 1 0 0 0 0 0 0 0 0 0 0 0 0 0 0 0 
0 1 0 0 0 0 0 1 1 0 0 0 0 0 0 0 0 1 0 0 0 0 0 0 0 0 0 0 0 0 0 0 
0 1 0 0 0 0 0 0 0 0 0 0 0 0 0 0 0 0 1 0 0 0 0 0 0 0 0 0 0 0 0 0 
0 1 0 0 0 0 0 0 0 0 0 0 0 0 0 0 0 0 0 1 0 0 0 0 0 0 0 0 0 0 0 0 
1 1 0 0 0 0 0 0 0 0 0 0 0 0 0 0 0 0 1 0 0 0 0 0 0 0 0 0 0 0 0 0 
0 0 0 0 1 0 0 0 0 0 0 0 0 0 0 0 0 1 0 0 0 0 0 0 0 0 0 0 0 0 0 0 
1 1 0 0 0 0 0 0 0 0 0 0 0 0 0 0 1 0 0 0 0 0 0 0 0 0 0 0 0 0 0 0 
0 1 0 0 0 0 0 0 0 0 0 0 0 0 0 0 0 1 0 0 0 0 0 0 0 0 0 0 0 0 0 0 
0 1 0 0 0 0 0 0 0 0 0 0 0 0 0 0 0 0 1 0 0 0 0 0 0 0 0 0 0 0 0 0 
0 1 0 0 0 0 0 0 0 0 0 0 0 0 0 0 0 0 0 1 0 0 0 0 0 0 0 0 0 0 0 0 
0 1 0 0 0 0 0 0 0 0 0 0 0 0 0 0 0 0 0 0 1 0 0 0 0 0 0 0 0 0 0 0 
0 1 0 0 0 0 0 0 0 0 0 0 0 0 0 0 0 0 0 0 1 0 0 0 0 0 0 0 0 0 0 0 
0 1 0 0 0 0 0 0 0 0 0 0 0 0 0 0 0 0 0 0 1 0 0 0 0 0 0 0 0 0 0 0 
0 1 0 0 0 0 0 0 0 0 0 0 0 0 0 1 0 0 0 0 1 0 0 0 0 0 0 0 0 0 0 0 
0 1 0 0 0 0 0 0 0 0 0 0 0 0 1 0 0 0 0 0 1 0 0 0 0 0 0 0 0 0 0 0 
0 1 0 0 0 0 0 0 0 0 0 0 0 1 1 1 1 1 1 1 1 0 0 0 0 0 0 0 0 0 0 0 
0 1 0 0 0 0 0 0 0 0 0 0 0 0 1 0 0 0 0 0 0 0 0 0 0 0 0 0 0 0 0 0 
0 1 0 0 0 0 0 0 0 0 0 0 0 0 0 1 0 0 0 0 0 0 0 0 0 0 0 0 0 0 0 1 
0 1 0 0 0 0 0 0 0 0 0 0 0 0 0 0 0 0 0 0 0 0 0 0 0 0 0 0 0 0 0 1 
0 1 0 0 0 0 0 0 0 0 0 0 0 0 0 0 0 0 0 0 0 0 0 0 0 0 0 0 0 0 0 1 
1 1 1 1 1 1 1 1 1 1 1 1 1 1 1 1 1 1 1 1 1 1 1 1 1 1 1 1 1 1 1 1 
